10 10
X X X X X X X X X X
X . . . . . . . Q X
X . X X X X X X X X
X . X X X X X X X X
X . X . . X X X X X
X . . K . . X X X X
X X X . X . . X X X
X X X X X X . X X X
X S . . . K . . X X
X X X X X X X X X X